######&&&&&&&&&&&&&&&&&&&&&&&&
#____|_____&________
#&&%o#&&&&_&________
#+&oo#&__&_&________
#____&___&_&________
#-##-#&&&&__________
&____&____&_________
&&&_&&&&&___________
&___&_______________
&&&&&_______________
&_&_________________
&___________________
&___________________